**********************************
*AAAAAAAAAAAAAAA**AAAAAAAAAAAAAAA*
*A*****A*******A**A*******A*****A*
*A*****A*******A**A*******A*****A*
*AAAAAAAAAAAA**AAAA**AAAAAAAAAAAA*
****A*******A**A**A**A*******A****
****A*******A**A**A**A*******A****
*AAAAAAAAA**A**A**A**A**AAAAAAAAA*
*A*******A**AAAA**AAAA**A*******A*
*A*******A**A********A**A*******A*
*AAAAAA**A**A********A**A**AAAAAA*
******A**AAAAAAAAAAAAAAAA**A******
******A**A**A***--***A**A**A******
******A**A**A*------*A**A**A******
*AAAAAAAAA**A*------*A**AAAAAAAAA*
******A*****A*------*A*****A******
******A*****A********A*****A******
*AAAAAAAAAAAAAAAAAAAAAAAAAAAAAAAA*
*A*******A**A********A**A*******A*
*A*******A**A********A**A*******A*
*A**AAAAAA**AAAA**AAAA**AAAAAA**A*
*A**A**********A**A**********A**A*
*A**A**********A**A**********A**A*
*AAAAAAAAAAAAAAAAAAAAAAAAAAAAAAAA*
******A**A**************A**A******
******A**A**************A**A******
*AAAAAA**AAAAAAA**AAAAAAA**AAAAAA*
*A*************A**A*************A*
*A*************A**A*************A*
*AAAAAAAAAAAAAAA**AAAAAAAAAAAAAAA*
**********************************