**********************************
*jump␣on␣red␣van**the␣quick␣brows*
*␣*****a*******f**e*******y*****a*
*f*****␣*******a**h*******e*****h*
*i*****w*******r**t*******s*****o*
*xa␣gentle␣planet␣swept␣launch␣it*
*␣*****q**a************i**c*****␣*
*u*****u**n************t**a*****i*
*pwildei**dalong**rivers**section*
*␣*****c*******o**o*******t*****␣*
*j*****k*******l**e*******i*****m*
*e*****l**fresh␣earth␣an**n*****a*
*t*****y**c*****=******w**g*****x*
*␣*****␣**a*****=******o**␣*****␣*
*agentblast****====****lamlightij*
*n*****v**r************f**o*****e*
*d*****e**y************␣**n*****t*
*␣*****r**ialong␣the␣wap**g*****␣*
*g*****s**g************o**␣*****c*
*l*****␣**␣************d**s*****l*
*ora␣wonderful␣s**sed␣ut␣perspi␣u*
*w*****t*******u**a*******g*****b*
*␣*****e*******p**d*******o*****␣*
*dogs**nthe␣sun␣rays␣began␣**cats*
****o**s**n************o**b**e****
****x**e**d************d**a**p****
*faintly**waters**ascent**invitec*
*o*************o**m*************a*
*x*************n**p*************l*
*turned␣cold␣as␣birds␣flew␣past␣m*
**********************************