**********************************
*thegodfather**hero**guardiansgal*
*a**********␣**␣**␣**i**********i*
*l**********a**a**c**␣**********g*
*e**may␣the␣forc**batman␣saves**h*
*n**␣**s*******t**e*******b**u**t*
*tune**e*******i**a*******l**base*
****m**x*******o**r*******e**j****
****x**tony␣stark␣builds␣im**e****
*plan*****x************x*****carh*
*r**A*****␣************␣*****t**e*
*a**star␣wars␣is␣my␣favorite␣**xa*
*y*****u**d*****=******u**r*****r*
*␣*****a**m*****=******t**a*****␣*
*trouble**i****====****p**transit*
*h**␣*****r************u*****␣**h*
*e**x*****e************c*****x**e*
*␣**joker␣plans␣his␣next␣schem**␣*
*d*****x*******x**x*******x*****b*
*r*****u*******i**a*******e*****a*
*uniform**uneasy**unpaid**uncover*
****␣**␣**r************e**␣**␣****
****x**x**a************x**z**z****
*luke**may␣the␣force␣be␣wit**hyou*
*i*****␣*******z**␣*******␣*****a*
*b*****x*******x**z*******z*****z*
*elastic**beauty**forest**markets*
*r*****␣**␣************␣**␣*****␣*
*t*****z**z************x**x*****z*
*youth␣culture␣spreads␣fast␣on␣fb*
**********************************