**********************************
*forest␣**i␣love␣piczas␣**journey*
*␣*****x**t************b**␣*****a*
*d*****r**x************a**t*****r*
*cats␣and␣bogs␣are␣best␣friends␣e*
*␣***b**s******l**a******b**␣***s*
*s***a**a******␣**r******␣**a***␣*
*a***r**␣******a**e******a**r***o*
*world**computer**mountain**beach*
*s***e*****␣**********b*****␣***s*
*a***o*****a**********a*****o***t*
*n***birds␣fly␣high␣in␣the␣sk***a*
*d***k*****r****=*****l*****v***y*
*w***i*****y****=*****i*****a*** *
*i***n**love***====***home**c***c*
*␣***a**u**␣**********e**a**e***a*
*a***␣**x**w**********x**x**␣***l*
*children**informationm**ountains*
*g***b*********g**␣*********x***m*
*r***a*********a**x*********a***a*
*o***hops␣exist␣**sunsy␣help␣***k*
*w***r******␣********␣******r***e*
*␣***␣******r********x******y***y*
*friendship␣makes␣life␣more␣fun␣s*
*a*****l*******␣**a*******s*****t*
*s*****i*******t**y*******m*****i*
*t*****g**flower**travel**i*****m*
*␣*****h**a************a**l*****e*
*x*****t**x************x**e*****s*
*nature␣is␣beautiful␣and␣calming␣*
**********************************