**********************************
*discovery**game␣shows**fantasies*
*h*******a**e********i**o*******i*
*e*******s**t********p**x*******m*
*castle**kingdom**diamond**bridge*
******a**e**e**a**o**e**i**u******
******t**y**l**y**g**l**m**s******
*dangerous**a**star**o**dangerous*
******a**a**x********d**x**␣******
******␣**␣**y********y**␣**a******
*circle**take␣short␣break**wonder*
*a*******e**a***=****a**j*******a*
*␣*******␣**␣***=****␣**␣*******␣*
*chemistry**w**====**s**beautiful*
****␣*******i********t*******␣****
****a*******n********a*******s****
*landscape**d********r**journaled*
*o*******n**motivation**i*******a*
*g*******t**a********e**g*******y*
*flower**r**r********w**s**rocket*
******o**o**song**bird**a**u******
******s**p**a**u**␣**␣**w**␣******
******a**y**d**n**x**e**␣**x******
*unbelievable**fire**instrumental*
******c**␣*****o**a*****a**␣******
******␣**f*****g**r*****s**w******
*wonder**capitol**marbley**silver*
*a*******e**f********u**u*******a*
*␣*******␣**␣********␣**␣*******␣*
*education**helicopter**admirable*
**********************************